border_size=1
usage=map

Gd, Gd, Aa, Aa, Gd, Gd, Gd, Gd, Gd, Gd, Gll^Fdw, Gd, Gd, Gd, Gll^Fdf, Gll^Fdf, Rp, Rp, Gd, Gll^Fdw, Gd, Gd, Gd, Gd, Gd, Gll^Fdw, Gd, Gd, Gd, Gd, Gd, Re, Ss, Wo, Wo, Aa, Gd, Gd, Gd, Gd, Gd, Gd, Re, Ww
Gd, Aa, Aa, Aa, Aa, Aa^Edb, Aa, Aa, Gd, Gd^Vhr, Rp, Rp, Rp, Gll^Fdw, Rp, Rp, Gd, Gd, Gd^Vhr, Gll^Fdw, Gd, Gd, Gd, Gll^Fdf, Gll^Fdw, Gll^Fdf, Gll^Fdw, Gd, Gd, Gd, Gs^Vc, Re, Ss, Wo, Aa, Re, Gd, Gd, Rp, Gd, Gd, Gd, Re, Ww
Gd, Aa, Aa, Aa, Aa, Gd, Gd, Gd, Rp, Rp, Gd, Gd, Gd, Rp, Gd^Vhr, Gll^Fdw, Gd, Gll^Fdw, Gll^Fdw, Gd, Hhd, Hhd, Hhd, Gll^Fdw, Gll^Fdw, Hhd^Vhhr, Gd, Gd, Gd, Gd, Re, Re, Wo, Wo, Re, Gd, Rp, Rp, Gd^Vhr, Rp, Rp, Gd, Gd^Vhr, Ww
Gd, Ha, Ha, Ha, Ha, Gd, Ch, Ch, Ch, Gd, Gd^Edp, Re^Gvs, Re^Gvs, Gd, Gll^Fdw, Gll^Fdf, Gll^Fdw, Gd, Gd, Hhd, Hhd, Mm, Hhd, Hhd, Gd, Ce, Ce, Ce, Rp, Rp, Rp, Ss, Wo, Wo, Rp, Rp, Gll^Fdw, Co, Co, Co, Gd, Rp, Rp, Ww
Hhd, Hhd, Ha, Ha^Vhha, Ha, Hhd, Ch, 2 Kh, Ch, Gd, Gd^Gvs, Re^Gvs, Re^Gvs, Re^Gvs, Re^Gvs, Gd, Gd, Gd, Hhd, Mm, Mm, Mm, Mm, Hhd, Hhd, Ce, 7 Ket, Ce, Gll^Fdw, Gll^Fdw, Gll^Fdw, Rp, Wo^Bw\, Wo^Bw/, Ss, Gd, Rp, Co, 4 Ko, Co, Gd, Gd, Re, Ww^Bw\
Mm, Mm, Mm, Mm, Mm, Hhd, Hhd, Ch, Gd, Rp, Gd, Re^Gvs, Re^Gvs, Re^Gvs, Re^Gvs, Gs^Vc, Gd, Gd, Hhd, Mm, Mm, Mm, Mm, Mm, Mm, Hhd, Ce, Gll^Fdw, Gll^Fdf, Rp^Vhcr, Gll^Fdw, Gll^Fdw, Wo, Wo, Gll^Fdw, Rp, Gll^Fdw, Gll^Fdw, Co, Gll^Fdw, Gll^Fdw, Gll^Fdw, Ww, Ww
Mm, Mm, Mm, Mm, Mm, Hhd, Hhd, Rp, Gd^Vhr, Rp, Gd, Gd^Wm, Hhd, Re^Gvs, Hhd, Gd, Gd, Hhd, Hhd, Ha, Mm, Md, Md, Md, Md, Mm, Mm, Hhd, Gll^Fdf, Gll^Fdf, Gll^Fdf, Gll^Fdw, Wo, Wo, Rp, Rp, Gll^Fdw, Gd, Gll^Fdw, Hhd, Gd, Gll^Fdw, Ww, Ww
Mm, Mm, Mm, Mm, Hhd, Hhd, Hhd, Rp, Hhd, Rp, Rp, Hhd, Hhd, Hhd, Hhd, Hhd, Hhd, Hhd, Hhd, Hhd, Hhd, Hhd^Edt, Ss, Ss^Vhs, Ss, Md, Mm, Hhd, Hhd, Md, Md, Md, Ss, Wo, Rp, Gll^Fdf, Gll^Fdw, Gd, Gll^Fdw, Hhd, Hhd, Re, Ww, Re
Hh, Mm, Mm, Mm, Hhd^Edb, Hhd, Hhd, Rp, Hhd, Hhd, Mm, Mm, Mm, Mm, Mm, Mm, Mm, Mm, Mm, Mm, Mm, Hhd, Hhd, Ss, Hhd, Hhd, Hhd, Hhd, Hhd, Md, Mm, Md, Md, Ss, Rp, Gll^Fdw, Gll^Fdw, Gll^Fdf, Gll^Fdw, Gll^Fdw, Ss^Vhs, Ww, Re, Ss
Mm, Mm, Mm, Mm, Hhd, Hhd, Hhd, Rp, Rp, Md, Mm, Mm, Mm^Xm, Mm, Mm^Xm, Mm, Mm^Xm, Mm, Mm^Xm, Mm, Mm, Mm, Mm, Hhd, Mm, Hhd, Hhd, Hhd, Mm, Mm, Mm, Mm, Md, Ss, Rp, Gll^Fdw, Rp^Vhcr, Gll^Fdw, Gll^Fdf, Hhd, Ww, Ww, Re, Gd
Mm, Mm, Mm, Mm, Hhd, Hhd, Hhd, Md, Md, Md, Mm^Xm, Mm^Xm, Mm^Xm, Hhd^Vhhr, Mm^Xm, Mm^Xm, Xu, Mm^Xm, Xu, Mm^Xm, Mm^Xm, Mm, Mm^Xm, Mm, Mm, Mm, Mm, Mm, Ds, Ds, Md, Md, Rp, Rp, Gd^Efm, Gll^Fdf, Gll^Fdf, Hhd, Mm, Hhd, Ww, Re, Gd, Rp
Mm, Mm, Mm, Mm, Hhd, Gll^Fdf, Md, Mm, Mm^Xm, Mm^Xm, Mm^Xm, Mm^Xm, Xu, Mm, Xu, Xu, Xu, Xu, Xu, Xu, Xu, Hhd^Vhhr, Xu, Mm^Xm, Mm^Xm, Mm, Mm, Mm, Ds, Ds, Rp, Rp, Gd, Gd, Hhd, Mm, Mm, Mm, Md, Hhd, Ww, Re, Gd^Edp, Rp
Mm, Mm, Mm, Mm, Hhd^Edt, Hhd, Mm, Mm, Mm^Xm, Mm^Xm, Xu, Xu, Uu^Ii, Uh^Ii, Urb^Ii, Urb, Urb, Uu^Vu, Uue, Xu, Xu, Uh^Ii, Xu, Xu, Mm^Xm, Mm, Mm, Mm, Rp, Rp, Gd^Vhr, Gll^Fdw, Gll^Fdw, Hhd, Md, Md, Md, Md, Ww, Hhd, Ww, Ss, Gd^Edt, Rp
Ha, Hhd, Hhd, Hhd, Hhd, Mm, Mm, Mm^Xm, Mm^Xm, Mm^Xm, Xu, Xu, Uu, Uu^Ii, Urb, Urb, Uu, Urb, Uue, Xu, Xu, Uu^Ufi, Uu^Uf, Xu, Xu, Mm^Xm, Mm^Xm, Mm, Rp, Ww^Ewf, Ww, Ww, Ww, Ww, Md, Ww, Ww, Md, Ww, Ww, Hhd, Ss, Gd, Rp
Ha, Hhd, Hhd^Edb, Gd^Vhr, Gll^Fdw, Md, Mm, Mm^Xm, Mm^Xm, Xu, Uu^Uf, Uu, Uu, Urb, Chr, Chr, Chr, Urb, Uu^Vu, Uue, Xu, Xu, Uu, Uu^Uf, Xu, Xu, Mm^Xm, Mm^Xm, Md, Md, Ww, Ww, Ww, Ww, Ww, Md, Ww, Ww, Ww, Ww, Re, Aa, Aa, Rp
Aa, Hhd, Hhd, Hhd, Hhd, Md, Mm, Mm^Xm, Mm^Xm, Xu, Xu, Uu, Uu^Vu, Uu, Chr, Khr, Urb, Uu, Xu, Xu, Qxu, Uue, Chr, Uu, Xu, Xu, Mm^Xm, Mm^Xm, Mm^Xm, Md, Ww, Ww, Ww, Ww^Ewf, Ww, Md, Ww, Ww, Ww^Ewf, Ww, Ww, Re, Gd, Rp
Gd, Gd, Gd, Hhd, Hhd, Md, Md, Mm^Xm, Mm^Xm, Mm^Xm, Xu, Xu, Uu, Uu, Uu, Urb, Urb, Uu, Xu, Qxu, Qxu, Chr, Chr, Uu, Xu, Xu, Xu, Mm^Xm, Mm^Xm, Mm^Xm, Ww, Ai, Ww, Ww, Ww, Ww, Ww, Ww, Ww, Ww, Ww, Re^Edt, Rp, Rp
Aa, Aa, Gd, Hhd, Rp, Rp, Hhd, Mm, Mm, Mm^Xm, Mm^Xm, Xu, Xu, Uh, Uh, Uu, Urb, Uu, Xu, Xu, Qxu, Uue, Uue, Uu, Uu, Xu, Xu, Xu, Mm^Xm, Mm^Xm, Ww, Ai, Ww, Ww, Md, Ww, Md, Ww, Hhd^Vhhr, Ww, Re, Re, Rp, Gd
Aa, Aa, Aa, Rp, Gll^Fdw, Gll^Fdw, Gll^Fdw, Hhd, Mm, Mm^Xm, Mm^Xm, Mm^Xm, Xu, Xu, Uh, Uu, Urb, Urb, Urb, Urb, Qxu, Urb, Urb, Uue, Uue, Uu^Vu, Xu, Xu, Mm^Xm, Mm^Xm, Mm^Xm, Mm, Gd^Vhr, Md, Mm, Md, Mm, Md, Hhd, Re, Rp, Rp, Gd, Gd
Aa, Aa, Aa, Co, Co, Co, Rb, Hhd, Hhd^Vhhr, Mm, Mm^Xm, Mm^Xm, Mm^Xm, Xu, Xu, Uu, Uu^Vu, Urb, Urb, Urb, Cud, Cud, Cud, Urb, Uue, Uu, Xu, Xu, Xu, Mm^Xm, Mm^Xm, Mm^Xm, Mm, Hhd, Mm, Mm, Mm, Hhd, Gd, Gd, Rp, Gd, Gd, Gd
Rp, Rp, Gd, Co, 6 Ko, Co, Rp, Rp, Rp, Md, Mm, Mm^Xm, Mm^Xm, Xu, Uh^Ii, Uu, Urb, Urb, Urb, Cud, Cud, 9 Kud, Cud, Cud, Uu, Uue, Uu^Vu, Xu, Xu, Xu, Mm^Xm, Mm^Xm, Mm^Xm, Mm, Mm, Mm, Hhd, Chr, Chr, Chr, Rp, Gd^Vhr, Gd, Gd
Rp, Gd^Vhr, Gd, Gd, Co, Gll^Fdw, Gd, Ss, Ss, Md, Md, Mm^Xm, Hhd^Vhhr, Uh^Ii, Xu, Uu, Urb, Urb, Urb, Cud, Cud, Cud, Cud, Cud, Uu, Uu, Uue, Uu, Uu, Xu, Xu, Mm^Xm, Mm, Mm, Mm, Hhd, Hhd, Chr, 8 Khr, Chr, Gd, Gd, Gd^Efm, Gd
Gll^Fdf, Gll^Fdw, Gll^Fdw, Gd, Gll^Fdw, Gll^Fdw, Gll^Fdw, Ss, Ss, Ss, Hhd, Md, Mm^Xm, Mm^Xm, Mm^Xm, Xu, Urb, Urb, Urb, Urb, Urb, Urb, Urb, Urb, Uu, Uu, Xu, Uu, Uu, Xu, Uh^Ii, Hh^Vhh, Mm^Xm, Mm^Xm, Mm, Mm, Hhd, Hhd, Chr, Gd^Edt, Gd, Gd, Gd, Gd
Re, Gll^Fdf, Gd, Gd, Gd^Edt, Gd, Gll^Fdw, Gll^Fdf, Ss, Ss, Md, Md, Mm^Xm, Mm^Xm, Xu, Xu, Chr, Chr, Urb, Uu, Uu, Uu, Uu^Vu, Urb, Uu, Uu, Uu, Xu, Xu, Uu^Ii, Xu, Xu, Mm^Xm, Mm^Xm, Mm, Mm, Ha^Vhha, Aa^Edb, Gd, Gd, Gd^Gvs, Re^Gvs, Re^Gvs, Gd
Ss, Re, Re, Gd, Gd^Edp, Gd, Gll^Fdw, Ss, Ss, Ss, Md, Md, Mm^Xm, Mm^Xm, Xu, Uu, Uu, Urb, Xu, Uu^Vu, Uu, Uu, Uu, Uu, Chr, Chr, Chr, Uu, Uu, Xu, Xu, Xu, Mm^Xm, Mm^Xm, Mm, Mm, Hhd, Gd, Gd^Efm, Gd, Gd, Re^Gvs, Re^Gvs, Re^Gvs
Ss, Ss, Ss, Re, Re, Gd, Rp, Rp, Rp, Rp, Md, Md, Mm^Xm, Mm^Xm, Xu, Xu, Uh^Ii, Urb, Urb, Uu^Uf, Uu, Uu, Qxu, Uu, Uu, Khr, Uu, Uu, Uu, Uu^Vu, Xu, Xu, Mm^Xm, Mm^Xm, Mm, Hhd, Hhd, Gd, Gd, Gd, Gll^Fdw, Gll^Fdw, Gd, Gd
Re, Ss, Re, Ss, Rp, Rp, Gll^Fdw, Gd, Gd, Hhd, Gll^Fdw, Md, Mm^Xm, Mm^Xm, Hhd^Vhhr, Uh^Ii, Urb^Ii, Urb, Xu, Uu^Uf, Uu, Uu, Uu, Uu, Uu, Uu, Uu, Uu^Uf, Uu^Uf, Uu, Xu, Xu, Mm^Xm, Mm^Xm, Mm, Mm, Hhd, Hhd, Gd, Gll^Fdf, Gll^Fdw, Gll^Fdw, Gll^Fdf, Gll^Fdw
Gd, Re, Gd, Re, Rp, Gd, Gll^Fdf, Gd, Gll^Fdw, Gll^Fdw, Rp^Vhcr, Md, Hhd, Mm, Mm^Xm, Xu, Xu, Urb, Xu, Uu, Uu, Uu, Uu, Uu^Vu, Xu, Uu, Xu, Uu^Uf, Uu^Ufi, Uu^Ii, Xu, Mm^Xm, Mm^Xm, Mm^Xm, Mm, Mm, Hhd, Gd^Edb, Gd, Gd, Gll^Fdw, Gll^Fdw, Gll^Fdw, Gll^Fdf
Gd, Gd, Gd^Vhr, Rp, Gd, Re, Gll^Fdw, Gll^Fdw, Gd^Vhr, Gd, Ww, Hhd, Md, Mm^Xm, Mm^Xm, Xu, Xu, Xu, Xu, Uu, Xu, Uu^Ii, Xu, Xu, Mm^Xm, Xu, Mm^Xm, Xu, Xu, Uh^Ii, Mm, Mm^Xm, Mm^Xm, Mm, Hhd, Hhd, Gd, Gd, Re^Gvs, Gd, Gd, Rp^Vhcr, Gll^Fdw, Hhd
Gd, Gd, Rp, Rp, Gll^Fdw, Re, Gll^Fdw, Ww, Ww, Ww, Ww, Ww, Md, Mm^Xm, Mm^Xm, Mm^Xm, Mm^Xm, Mm^Xm, Mm^Xm, Xu, Mm^Xm, Uh^Ii, Mm^Xm, Mm^Xm, Mm^Xm, Mm^Xm, Mm^Xm, Mm^Xm, Mm^Xm, Hhd^Vhhr, Mm^Xm, Mm, Mm, Md, Rp, Gd, Re^Gvs, Re^Gvs, Re^Gvs, Re^Gvs, Gll^Fdw, Gll^Fdw, Gll^Fdf, Gll^Fdw
Gd, Gd, Rp, Gd, Gd, Gd, Re, Ww, Ww, Ww^Ewf, Ww, Ww, Ww, Ha, Mm, Mm^Xm, Mm, Mm^Xm, Mm^Xm, Mm^Xm, Mm^Xm, Hhd^Vhhr, Mm^Xm, Mm^Xm, Mm, Mm, Mm, Mm^Xm, Mm^Xm, Mm, Mm, Mm, Hhd, Hhd, Rp, Gd, Gd, Re^Gvs, Gd, Gll^Fdw, Gd, Gd, Gll^Fdw, Gll^Fdw
Gd, Gd^Edp, Rp, Gd, Gd, Re, Gd, Ww, Ww, Ww, Ww, Ai, Ww, Hhd, Hhd^Vhhr, Mm, Md, Mm, Mm, Mm^Xm, Mm, Mm, Mm, Mm, Mm, Mm, Mm, Mm, Mm, Mm, Mm, Hhd, Gd, Gd^Edt, Gd, Rp, Rp, Gd, Gd^Edt, Gd, Re^Gvs, Re^Gvs, Re^Gvs, Gll^Fdw
Gd, Gd, Aa, Aa, Gd, Re, Re^Wm, Gll^Fdw, Gd, Ww, Ww, Ai, Md, Hhd, Gd, Gd, Rr, Md, Gd, Mm, Mm, Mm, Gd, Gd, Gd, Gd^Edt, Gd, Mm, Hhd, Mm, Hhd, Hhd, Gd, Gd, Re^Gvs, Gd, Rp, Gd, Re^Gvs, Re^Gvs, Re^Gvs, Re^Gvs, Gd, Gll^Fdw
Gd, Gd, Rp, Gd, Re^Gvs, Re^Gvs, Re^Gvs, Gd, Gd, Hhd, Ww, Ai, Ww, Hhd, Gd, Gd, Rr, Gd, Gd, Gd, Gd, Hhd, Gd, Gd^Vhr, Gd, Gd, Gd, Gll^Fdw, Rp^Vhcr, Hhd, Gd, Ds, Re^Gvs, Re^Gvs, Re^Gvs, Gd, Rp, Gd^Wm, Gd, Re^Gvs, Gd, Gd, Re, Gll^Fdw
Gd, Gd^Edt, Rp, Re^Gvs, Re^Gvs, Re^Gvs, Gd, Gd, Hhd, Md, Ai, Md, Hhd, Gd, Gd^Efm, Gd, Rr, Gd^Edt, Gd, Gd^Edp, Gd, Hhd, Md, Hhd, Gll^Fdw, Gd, Gll^Fdw, Gll^Fdw, Gll^Fdw, Gll^Fdw, Gll^Fdw, Ds, Re^Gvs, Re^Gvs, Gd, Gd, Rr^Vhc, Rp, Gd, Gd, Gd^Efm, Re, Gll^Fdw, Gll^Fdw
Gd, Gd, Rp, Gd, Gd^Vhr, Gd, Gd^Edp, Hhd, Mm, Mm, Mm, Mm, Hhd^Vhhr, Gd, Gd, Gd, Gd, Rr, Gd, Gd, Hhd, Hhd, Md, Md, Gd, Gll^Fdw, Rp^Vhcr, Gll^Fdw, Gll^Fdw, Ss, Gll^Fdw, Ds, Gd, Gd, Gd, Gd, Gd, Rp, Rp, Gd, Gd, Gd, Gll^Fdf, Gll^Fdf
Rp, Rp, Gd, Gll^Fdw, Gll^Fdw, Gll^Fdw, Hhd, Mm, Mm, Mm, Mm, Ha, Gd, Aa, Aa, Gd, Gd^Edb, Rr, Gd^Vhr, Hhd, Hhd, Hhd, Md, Md, Hhd, Gd, Gll^Fdw, Gll^Fdw, Ss, Ss, Ss, Ss, Gll^Fdw, Gll^Fdf, Gll^Fdw, Gd, Gd, Gd, Aa, Rp, Gd, Gd, Gll^Fdw, Gll^Fdf
Rp, Rp, Rp, Ce, Ce, Ce, Hhd, Mm, Mm, Mm, Hhd, Aa, Aa, Aa, Aa, Gd, Gd, Rr, Rr, Gd, Cdr, Cdr, Cdr, Hhd, Hhd, Gll^Fdw, Gd, Gll^Fdf, Gll^Fdw, Ss, Re, Re, Ss, Rb, Gll^Fdw, Gll^Fdf, Gd, Ce, Ce, Ce, Gd, Gd, Gd, Gd
Gd, Rp, Gd, Ce, 3 Ke, Ce, Gll^Fdw, Hhd, Hhd, Hhd, Gd, Gd, Gd, Gd, Re, Gd, Gd, Gd, Gd, Rr, Cdr, 5 Kdr, Cdr, Gd, Gd, Gd, Re^Gvs, Gd^Gvs, Gd, Gll^Fdw, Gd, Rb, Rb, Rb, Gll^Fdw, Gd^Vhr, Gll^Fdw, Ce, 1 Ke, Ce, Gd, Gd, Gd, Gd
Aa, Rp, Rp, Gd, Ce, Rp, Rp, Gd, Gd, Gd, Gd, Gd^Edt, Gd, Re, Ss, Re, Re, Gd, Gd, Gd, Gd, Cdr, Gd, Gd, Gd^Efm, Re^Gvs, Re^Gvs, Re^Gvs, Gd, Gll^Fdw, Gd^Vhr, Gd, Gd, Gd, Gd, Gll^Fdw, Gll^Fdf, Gll^Fdw, Ce, Gd, Gd, Gd, Gd, Gd
Rp, Rp, Rp, Rp, Rp, Gll^Fdf, Gll^Fdw, Rp, Rp, Gd, Gd^Efm, Gd, Gd, Re, Ss, Ss, Re, Gd^Edt, Rp, Gd, Gd^Edt, Gd, Rp, Gd, Gd, Gd^Gvs, Rp, Re, Rb, Gd, Gll^Fdw, Gll^Fdw, Gd, Gd, Hhd, Hhd, Hhd, Hhd, Hhd, Hhd, Gd^Efm, Gd, Gd^Vhr, Gd
Gd, Rp^Vhcr, Gll^Fdw, Rp, Gll^Fdw, Rp, Rp, Gll^Fdw, Rp, Gd, Gd, Gd, Gd, Re, Re, Ss, Rp, Rp, Gd, Rp, Rp, Rp, Gd, Rp, Rp, Rp, Gd, Rp, Ss, Rb, Rb, Gd, Gll^Fdw, Gll^Fdf, Hhd, Hhd, Hhd, Md, Md, Hhd, Gd, Gd, Gd, Gd
Gd, Gll^Fdw, Gll^Fdw, Ss, Gll^Fdw, Rp^Vhcr, Gll^Fdf, Rp, Rp, Rp, Rp, Rp, Rp, Gd^Vhr, Rp, Rp, Gd, Gd, Gd, Gd, Gd^Vhr, Gd, Gd^Edp, Gd, Gd, Gd, Rb, Rp, Ss^Bw\, Ss, Rb, Gd, Gd, Gd, Gll^Fdw, Hhd, Md, Md, Md, Hhd, Hhd, Gd, Gd, Gd
Gll^Fdf, Gll^Fdf, Ss, Ss, Gll^Fdw, Gll^Fdw, Gd, Gd, Gd, Rp, Rp, Aa, Aa, Rp, Rp, Gd, Gll^Fdw, Gll^Fdw, Gd, Gd, Gd, Gd, Gd, Gd, Gd, Rb, Rb, Ss, Gg, Rr, Rr, Rr, Rr, Rr, Rr, Hhd, Hhd, Hhd, Rr, Rr, Gd, Gd, Gd, Gd
