Xv, Xv, Xv, Xv, Xv, Xv, Xv, Xv, Xv, Xv, Xv, Xv, Xv, Xv, Xv, Xv, Xv, Xv, Xv, Xv, Xv, Xv, Xv, Xv, Xv, Xv, Xv, Xv, Xv, Xv, Xv, Urb, Cud, Urb, Xv, Xv, Xv, Xv, Xv, Xv, Xv, Xv, Xv, Xv, Xv, Xv, Xv, Xv, Xv, Xv, Xv, Xv, Xv, Xv, Xv, Xv, Xv, Xv, Xv, Xv, Xv, Xv, Xv, Xv, Xv, Xv, Xv
Xv, Xv, Xv, Xv, Xv, Xv, Xv, Xv, Xv, Xv, Xv, Xv, Xv, Xv, Xv, Xv, Xv, Xv, Xv, Xv, Xv, Xv, Xv, Xv, Xv, Xv, Xv, Xv, Xv, Xv, Uu, Cud, 6 Kud, Cud, Uu, Xv, Xv, Xv, Xv, Xv, Xv, Xv, Xv, Xv, Xv, Xv, Xv, Xv, Xv, Xv, Xv, Xv, Xv, Xv, Xv, Xv, Xv, Xv, Xv, Xv, Xv, Xv, Xv, Xv, Xv, Xv, Xv
Xv, Xv, Xv, Xv, Xv, Xv, Xv, Xv, Xv, Xv, Xv, Xv, Xv, Xv, Xv, Xv, Xv, Xv, Xv, Xv, Xv, Xv, Xv, Xv, Xv, Xv, Xv, Xv, Xu, Uu, Qxu, Cud, Cud, Cud, Urb, Urb, Xu, Xv, Xv, Xv, Xv, Xv, Xv, Xv, Xv, Xv, Xv, Xv, Xv, Xv, Xv, Xv, Xv, Xv, Xv, Xv, Xv, Xv, Xv, Xv, Xv, Xv, Xv, Xv, Xv, Xv, Xv
Xv, Xv, Xv, Xv, Xv, Xv, Xv, Xv, Xv, Xv, Xv, Xv, Xv, Xv, Xv, Xv, Xv, Xv, Xv, Xv, Xv, Xv, Xv, Xv, Xv, Xv, Xv, Xv, Uu, Uu, Uu^Vu, Urb, Qxu, Uu, Uu^Vu, Qxu, Uu, Urb, Xv, Xv, Xv, Xv, Xv, Xv, Xv, Xv, Xv, Xv, Xv, Xv, Xv, Xv, Xv, Xv, Xv, Xv, Xv, Xv, Xv, Xv, Xv, Xv, Xv, Xv, Xv, Xv, Xv
Xv, Xv, Xv, Xv, Xv, Xv, Xv, Xv, Xv, Xv, Xv, Xv, Xv, Xv, Xv, Xv, Xv, Xv, Xv, Xv, Xv, Xv, Xv, Xv, Xv, Xv, Md^Xm, Xu, Xu, Urb, Urb, Uu, Uu, Urb, Uu, Urb, Urb, Urb, Xu, Xv, Xv, Xv, Xv, Xv, Xv, Xv, Xv, Xv, Xv, Xv, Xv, Xv, Xv, Xv, Xv, Xv, Xv, Xv, Xv, Xv, Xv, Xv, Xv, Xv, Xv, Xv, Xv
Xv, Xv, Xv, Xv, Xv, Xv, Xv, Xv, Xv, Xv, Xv, Xv, Xv, Xv, Xv, Xv, Xv, Xv, Xv, Xv, Xv, Xv, Xv, Xv, Xv, Xv, Md^Xm, Md^Xm, Md^Xm, Uh^Ii, Xu, Xu, Uh^Ii, Xu, Uh^Ii, Xu, Xu, Uh^Ii, Md^Xm, Md^Xm, Xv, Xv, Xv, Xv, Xv, Xv, Xv, Xv, Xv, Xv, Xv, Xv, Xv, Xv, Xv, Xv, Xv, Xv, Xv, Xv, Xv, Xv, Xv, Xv, Xv, Xv, Xv
Xv, Xv, Xv, Xv, Xv, Xv, Xv, Xv, Xv, Xv, Xv, Xv, Xv, Xv, Xv, Xv, Xv, Xv, Xv, Xv, Xv, Xv, Xv, Xv, Gd, Md, Md, Md^Xm, Rp, Hhd^Vhhr, Md^Xm, Md^Xm, Rp^Dr, Md^Xm, Md, Md^Xm, Md^Xm, Rp^Dr, Hhd^Vhhr, Md^Xm, Md, Xv, Xv, Xv, Xv, Xv, Xv, Xv, Xv, Xv, Xv, Xv, Xv, Xv, Xv, Xv, Xv, Xv, Xv, Xv, Xv, Xv, Xv, Xv, Xv, Xv, Xv
Xv, Xv, Xv, Xv, Xv, Xv, Xv, Xv, Xv, Xv, Xv, Xv, Xv, Xv, Xv, Xv, Xv, Xv, Xv, Xv, Xv, Xv, Xv, Hhd, Gd^Edt, Gd, Khr, Hhd, Hhd, Md, Md, Md^Xm, Rp, Md^Xm, Hhd^Vhhr, Md, Md, Rp, Md, Md, Hhd, Gd, Xv, Xv, Xv, Xv, Xv, Xv, Xv, Xv, Xv, Xv, Xv, Xv, Xv, Xv, Xv, Xv, Xv, Xv, Xv, Xv, Xv, Xv, Xv, Xv, Xv
Xv, Xv, Xv, Xv, Xv, Xv, Xv, Xv, Xv, Xv, Xv, Xv, Xv, Xv, Xv, Xv, Xv, Xv, Xv, Xv, Xv, Xv, Gd, Hhd, Md, Chr, Gll^Fdw, Rp, Ss^Vhs, Wwf, Rp, Rp, Ss^Vhs, Gd, Md, Gd, Rp, Rp, Hhd, Md, Gd, Hhd, Md, Xv, Xv, Xv, Xv, Xv, Xv, Xv, Xv, Xv, Xv, Xv, Xv, Xv, Xv, Xv, Xv, Xv, Xv, Xv, Xv, Xv, Xv, Xv, Xv
Xv, Xv, Xv, Xv, Xv, Xv, Xv, Xv, Xv, Xv, Xv, Xv, Xv, Xv, Xv, Xv, Xv, Xv, Xv, Xv, Xv, Hhd, Hhd, Hhd, Md, Md, Md, Rp, Wwrg^Bw\r, Wwf, Hhd, Md, Md, Md, Md, Md, Rp, Khr, Gd, Gd, Hhd, Md, Md, Md, Hhd, Xv, Xv, Xv, Xv, Xv, Xv, Xv, Xv, Xv, Xv, Xv, Xv, Xv, Xv, Xv, Xv, Xv, Xv, Xv, Xv, Xv, Xv
Xv, Xv, Xv, Xv, Xv, Xv, Xv, Xv, Xv, Xv, Xv, Xv, Xv, Xv, Xv, Xv, Xv, Xv, Xv, Xv, Gd, Hhd, Gs^Vc, Hhd, Hhd, Md, Hhd, Rp, Wwf, Gd, Chr, Khr, Hhd, Md, Md, Hhd, Rp, Chr, Rp, Gd^Efm, Gs^Vc, Hhd, Wwf, Hhd, Gd, Xv, Xv, Xv, Xv, Xv, Xv, Xv, Xv, Xv, Xv, Xv, Xv, Xv, Xv, Xv, Xv, Xv, Xv, Xv, Xv, Xv, Xv
Xv, Xv, Xv, Xv, Xv, Xv, Xv, Xv, Xv, Xv, Xv, Xv, Xv, Xv, Xv, Xv, Xv, Xv, Gll^Fdw, Gd, Gd^Es, Gd, Gd, Hhd, Hhd, Hhd^Es, Gd, Rp, Wwrg, Gd, Gs^Vc, Rp, Hhd, Wwf, Hhd, Hhd, Rp, Gd, Hhd, Rp, Rp, Hhd, Ww^Ewf, Hhd, Gd^Vhr, Gd^Es, Gd^Edb, Xv, Xv, Xv, Xv, Xv, Xv, Xv, Xv, Xv, Xv, Xv, Xv, Xv, Xv, Xv, Xv, Xv, Xv, Xv, Xv
Xv, Xv, Xv, Xv, Xv, Xv, Xv, Xv, Xv, Xv, Xv, Xv, Xv, Xv, Xv, Xv, Xv, Xv, Gll^Fdf, Gd, Gll^Fdf, Gd, Gll^Fdw, Gd, Gd, Gd^Edp, Rp, Rp, Wwf, Gd, Gd, Rp, Wwf^Bw\r, Wwrg, Hhd^Vhhr, Hhd, Rp, Hhd, Md, Hhd^Edb, Hhd, Rp, Wwrg^Bw\r, Gd, Gd, Gd, Gll^Fdw, Xv, Xv, Xv, Xv, Xv, Xv, Xv, Xv, Xv, Xv, Xv, Xv, Xv, Xv, Xv, Xv, Xv, Xv, Xv, Xv
Xv, Xv, Xv, Xv, Xv, Xv, Xv, Xv, Xv, Xv, Xv, Xv, Xv, Xv, Xv, Xv, Gd, Gd^Edt, Gll^Fdw, Gll^Fdw, Gll^Fdw, Gd, Gll^Fdf, Chr, Chr, Rp, Hhd, Rp, Wwf, Gd, Wwf, Wwrg, Rp, Gd, Dd, Rp, Hhd, Md, Md, Md, Hhd, Gd^Edt, Wwf, Rp, Chr, Hhd, Gll^Fdw, Gll^Fdw, Gd^Edt, Xv, Xv, Xv, Xv, Xv, Xv, Xv, Xv, Xv, Xv, Xv, Xv, Xv, Xv, Xv, Xv, Xv, Xv
Xv, Xv, Xv, Xv, Xv, Xv, Xv, Xv, Xv, Xv, Xv, Xv, Xv, Xv, Xv, Xv, Rp, Gd^Esd, Rp, Gd, Rp, Gll^Fdf, Chr, 4 Khr, Hhd, Hhd, Md, Hhd, Ww^Ewf, Wwrg, Re^Gvs, Re^Gvs, Gd^Gvs, Rp, Rp, Rp, Gd, Hhd, Md, Md, Hhd, Gd, Wwrg, Chr, Chr, Gll^Fdf, Rp, Gll^Fdf, Rp, Xv, Xv, Xv, Xv, Xv, Xv, Xv, Xv, Xv, Xv, Xv, Xv, Xv, Xv, Xv, Xv, Xv, Xv
Xv, Xv, Xv, Xv, Xv, Xv, Xv, Xv, Xv, Xv, Xv, Xv, Xv, Xv, Gd, Rp, Hhd, Rp, Hhd, Rp, Gd^Vhr, Rp, Hhd, Chr, Hhd, Hhd, Md, Md, Wwg, Re^Gvs, Re^Gvs, Re^Gvs, Gll^Fdw, Gll^Fdw, Rp, Gd, Hhd, Hhd, Hhd, Hhd, Dd, Gd^Edt, Wwg, Chr, Rp, 5 Khr, Gd, Rp, Md, Rp, Gd, Xv, Xv, Xv, Xv, Xv, Xv, Xv, Xv, Xv, Xv, Xv, Xv, Xv, Xv, Xv, Xv
Xv, Xv, Xv, Xv, Xv, Xv, Xv, Xv, Xv, Xv, Xv, Xv, Xv, Xv, Hhd, Hhd, Md, Hhd, Hhd, Gd, Re^Gvs, Gd, Hhd, Rp, Gd^Wm, Hhd, Hhd^Vhhr, Hhd, Wwg, Gd, Gd, Re^Gvs, Gll^Fdw, Gll^Fdf, Khr, Chr, Rp, Hhd, Gd^Vhr, Gd^Edt, Rp, Rp, Wwg, Gd, Gd^Efm, Rp, Hhd, Md, Md, Hhd^Vhhr, Hhd, Xv, Xv, Xv, Xv, Xv, Xv, Xv, Xv, Xv, Xv, Xv, Xv, Xv, Xv, Xv, Xv
Xv, Xv, Xv, Xv, Xv, Xv, Xv, Xv, Xv, Xv, Xv, Xv, Gd, Hhd, Hhd, Md, Md, Hhd, Re^Gvs, Re^Gvs, Re^Gvs, Gd^Efm, Rp, Rp, Gd, Gd, Gd, Hhd, Wwg, Gd, Gd^Edp, Gd, Gd, Chr, Chr, Chr, Gd, Rp, Rp, Rp, Ss, Ss^Vhs, Gd, Wwg, Gd^Es, Rp, Hhd, Md, Md, Hhd, Hhd, Gd, Gd, Xv, Xv, Xv, Xv, Xv, Xv, Xv, Xv, Xv, Xv, Xv, Xv, Xv, Xv
Xv, Xv, Xv, Xv, Xv, Xv, Xv, Xv, Xv, Xv, Xv, Xv, Gd, Gll^Fdf, Gd, Hhd^Es, Hhd, Hhd, Re^Gvs, Re^Gvs, Gd, Rp, Gll^Fdf, Gll^Fdw, Gll^Fdw, Gll^Fdf, Gd, Gd, Wwg, Gd^Es, Gd, Ss, Ss, Gd, Rp, Gd^Edp, Gd^Edp, Gd, Gd, Gd, Gd, Ss, Gd, Wwg, Gd^Esd, Rp, Rp, Hhd, Hhd, Hhd, Gd, Gd, Ss, Xv, Xv, Xv, Xv, Xv, Xv, Xv, Xv, Xv, Xv, Xv, Xv, Xv, Xv
Xv, Xv, Xv, Xv, Xv, Xv, Xv, Xv, Xv, Xv, Ss, Ss, Gll^Fdw, Gll^Fdw, Gd, Gd, Gd, Hhd, Gd, Gd, Gd, Rp, Gs^Vc, Gll^Fdf, Gll^Fdw, Gll^Fdw, Gd, Wwg, Gd^Edb, Gd, Ss, Ss, Gd^Fetd, Ss, Rp, Gd, Gd^Efm, Gs^Vc, Md, Hhd, Md, Gd, Gd, Wwg, Wwg, Gd, Gd, Rp, Gd, Gd, Gd, Ss, Ss, Ss, Gd, Xv, Xv, Xv, Xv, Xv, Xv, Xv, Xv, Xv, Xv, Xv, Xv
Xv, Xv, Xv, Xv, Xv, Xv, Xv, Xv, Xv, Xv, Gd, Ss, Gd, Gd, Gd, Gd, Ss, Ss, Ss, Ss^Vhs, Ss, Rp, Gd, Gd, Gd, Gd, Ww^Ewf, Wwg, Gd, Gd, Gd, Ss, Gd, Ss^Vhs, Ss^Bw|r, Gd, Gd, Hhd, Md, Md, Md, Hhd, Gd, Gd^Efm, Wwg, Gd^Edt, Gd, Rp, Rp, Gs^Vc, Gll^Fdw, Ss, Gll^Fdw, Gd^Efm, Gd, Xv, Xv, Xv, Xv, Xv, Xv, Xv, Xv, Xv, Xv, Xv, Xv
Xv, Xv, Xv, Xv, Xv, Xv, Xv, Xv, Gd, Gd^Edt, Gd, Gd, Gd, Gd^Edp, Gd, Ss, Gd^Vhr, Ss, Ss, Ss, Ss, Rp, Gd, Gd^Efm, Dd, Gd^Esd, Wwg, Gd^Efm, Gd, Gd^Es, Gd, Ss, Ss, Ss, Rp, Gd, Gd^Vhr, Hhd, Hhd, Md, Hhd, Hhd, Gd, Gd, Gd, Wwg, Ss, Gd^Fetd, Rp, Gd, Gll^Fdf, Gll^Fdf, Gd, Gd, Gd, Gd, Gd, Xv, Xv, Xv, Xv, Xv, Xv, Xv, Xv, Xv, Xv
Xv, Xv, Xv, Xv, Xv, Xv, Xv, Xv, Gd, Gd, Gd, Hhd^Es, Hhd, Gd, Gd^Edt, Gd, Gd, Gd, Gd, Ss, Rp, Rp, Gd^Edt, Gd, Gd, Wwg, Hhd^Es, Wwg, Gd, Gd, Gd, Gd, Gd, Ss, Rp, Gd, Re^Gvs, Re^Gvs, Re^Gvs, Hhd, Gd^Wm, Hhd, Gd, Gd, Gd^Efm, Wwg, Ss, Ss^Vhs, Rp, Gd^Edp, Gll^Fdw, Gll^Fdw, Gd, Gd^Edp, Gd, Gd^Vhr, Gd^Efm, Xv, Xv, Xv, Xv, Xv, Xv, Xv, Xv, Xv, Xv
Xv, Xv, Xv, Xv, Xv, Xv, Dd, Gll^Fdw, Gll^Fdw, Gd^Fetd, Gd, Hhd, Gs^Vc, Hhd, Gd, Gd^Es, Gd, Dd, Ce, Gd, Rp, Gd, Gd, Gd^Es, Ww^Ewf, Wwg, Gll^Fdw, Wwg, Wwg, Gd, Gd, Hhd, Hhd, Gd, Rp, Re^Gvs, Re^Gvs, Re^Gvs, Re^Gvs, Re^Gvs, Gll^Fdw, Gd, Gd^Edb, Gd, Gd, Wwg, Gd, Ss, Rp, Gd, Gd, Gd, Hhd, Gd, Ss, Gd, Gd, Dd, Gd, Xv, Xv, Xv, Xv, Xv, Xv, Xv, Xv
Xv, Xv, Xv, Xv, Xv, Xv, Gll^Fdf, Gll^Fdw, Gll^Fdw, Gll^Fdw, Gd, Gd, Gd, Gd, Gd^Efm, Gd^Edb, Gd, Ce, 3 Ke, Ce, Gd, Gd^Efm, Gd, Wwg, Gd, Gd, Gll^Fdw, Gd, Wwg, Gd^Vhr, Gd, Hhd, Gd, Hhd, Rp, Re^Gvs, Re^Gvs, Re^Gvs, Gd, Gll^Fdw, Gs^Vc, Gll^Fdw, Gll^Fdf, Gll^Fdf, Gd^Vhr, Wwg, Gd, Gd, Rp, Gd, Gd, Gs^Vc, Hhd, Hhd, Ss, Ss, Ss, Gd, Gd, Xv, Xv, Xv, Xv, Xv, Xv, Xv, Xv
Xv, Xv, Xv, Xv, Gll^Fdw, Gll^Fdw, Gll^Fdw, Gll^Fdw, Gd, Gll^Fdf, Gd, Gd, Ss, Gd, Gd, Gd, Gd, Gd, Ce, Ce, Rp, Gd, Wwg, Wwg, Gll^Fdw, Gll^Fdw, Gd, Gd^Esd, Wwg, Gd^Efm, Gd, Gd, Ce, Rp, Gll^Fdw, Gd, Gd, Gll^Fdw, Gll^Fdf, Gll^Fdw, Hhd, Gd, Gd, Gd, Rp, Wwg, Ce, Ce, Ce, Gll^Fdw, Gll^Fdw, Gd, Ss^Vhs, Ss, Ss, Ss, Gd, Ss, Gd, Gd, Gll^Fdw, Xv, Xv, Xv, Xv, Xv, Xv
Xv, Xv, Xv, Xv, Gd, Gll^Fdf, Gd, Gd, Gd, Gd^Vhr, Dd, Gd, Ss, Ss, Ss, Ss, Ss, Ss, Gd, Gd, Wwg, Wwg^Bw\r, Rp, Gd, Gll^Fdw, Gll^Fdw, Gd^Vhr, Gd, Wwg, Gd, Gd, Ce, 2 Ke, Ce, Rp, Gll^Fdw, Rp, Gd, Rp, Hhd, Hhd^Edt, Gd^Efm, Rp, Rp, Ww^Ewf, Wwg^Bw\r, Ce, 1 Ke, Gd, Gll^Fdf, Gll^Fdf, Gd, Gd, Ss, Gd, Gd, Re^Gvs, Gd^Wm, Gll^Fdw, Gd, Gll^Fdw, Xv, Xv, Xv, Xv, Xv, Xv
Xv, Xv, Gd, Gd^Edt, Gd, Gd, Gd^Edp, Gd, Gd^Efm, Gd, Gd, Gd, Gd, Ss, Ss, Ss^Vhs, Ss, Gd, Ww^Ewf, Wwg, Gd, Gd^Fetd, Re^Gvs, Rp, Rp, Gll^Fdw, Rp, Gd, Wwg^Bw/r, Rp, Rp, Ce, Gd, Ce, Gd, Rp, Gll^Fdw, Rp, Gd^Efm, Rp, Rp, Rp, Gd, Gd, Wwg, Wwg, Gd, Ce, Gll^Fdf, Gd, Gd, Gd, Gll^Fdw, Gd, Re^Gvs, Re^Gvs, Re^Gvs, Re^Gvs, Re^Gvs, Gll^Fdf, Gll^Fdw, Gll^Fdf, Gd, Xv, Xv, Xv, Xv
Xv, Xv, Ds, Ds, Ds^Es, Gd, Gd, Gd, Gd, Gd, Gd, Gd^Edp, Gd, Gd, Gd, Ss, Ss, Ss, Wwg, Gd, Gll^Fdw, Gd, Re^Gvs, Re^Gvs, Re^Gvs, Rp, Gd^Wm, Rp, Wwg, Gd, Ss, Ss, Ss, Gd, Gd, Gll^Fdw, Gll^Fdf, Gd, Gd, Gd, Gd^Edt, Gd, Gd, Wwg, Gll^Fdw, Wwg, Gd, Gd, Gd, Gll^Fdw, Gd, Gd, Gd, Gd, Gd, Re^Gvs, Re^Gvs, Re^Gvs, Gd, Gd, Gd, Gd, Ds^Es, Xv, Xv, Xv, Xv
Wog, Wog, Wog, Wog, Wog, Ds^Esd, Ds, Gd, Ds, Gd, Gd, Gd, Gd^Esd, Gd^Efm, Gd, Gd, Wwg, Wwg, Gd, Gd^Vhr, Gd, Re^Gvs, Re^Gvs, Re^Gvs, Re^Gvs, Re^Gvs, Gd, Gd, Wwg, Ss, Ss, Ss^Vhs, Ss, Ss, Gd, Gd, Gd, Gd, Gd^Vhr, Gd, Gd, Gd, Wwg, Wwg, Gll^Fdw, Ww^Ewf, Gd, Gd^Vhr, Gd, Gd, Gd^Efm, Gd, Gd^Es, Gd, Gd, Gd, Gd, Gd, Ds, Ds^Es, Ds, Ds, Wog, Wog, Wog, Xv, Xv
Wog, Wog, Wog, Wog, Wog, Wog, Wog, Ds, Wog, Ds, Ds^Esd, Ds^Es, Ds, Gd, Wwg, Wwg, Gd, Gd, Gd, Gd^Esd, Gd, Gd, Gd, Re^Gvs, Gd, Gd, Gd^Efm, Gd, Wwg, Ss, Gd, Gd, Gd, Gd, Gd, Gd, Gd^Edp, Gd, Gd, Gd, Gd, Wwg, Gd^Es, Gd, Gd^Edp, Wwg, Gd, Gd^Esd, Gd, Gd^Edt, Gd, Gd, Ds^Es, Gd, Ds, Ds, Ds, Ds, Wog, Wog, Wog, Wog, Wog, Wog, Wog, Wog, Wog
Wog, Wog, Wog, Wog, Wog, Wog, Wog, Wog, Wog, Wog, Wog, Wog, Wog, Ds^Es, Wog, Ds, Ds^Es, Ds, Ds, Ds, Ds, Gd^Edt, Gd, Gd, Gd, Gd, Gd, Gd, Gd, Wwg, Gd, Gd^Efm, Gd, Gd, Gd, Gd, Ds, Gd, Ds, Gd, Wwg, Wwg, Ds, Gd, Ds, Wwg, Ds, Ds, Ds, Ds, Ds, Ds, Wog, Ds, Wog, Wog, Wog, Wog, Wog, Wog, Wog, Wog, Wog, Wog, Wog, Wog, Wog
Wog, Wog, Wog, Wog, Wog, Wog, Wog, Wog, Wog, Wog, Wog, Wog, Wog, Wog, Wog, Wog, Wog, Wog, Wog, Wog, Wog, Ds, Ds, Ds^Esd, Ds^Es, Ds, Ds, Ds^Esd, Ds, Wwg, Ds, Ds, Ds, Ds, Ds, Ds, Wog, Ds^Esd, Wog, Wog, Wog, Ds, Wog, Ds^Es, Wog, Wog, Wog, Wog, Wog, Wog, Wog, Wog, Wog, Wog, Wog, Wog, Wog, Wog, Wog, Wog, Wog, Wog, Wog, Wog, Wog, Wog, Wog
Wog, Wog, Wog, Wog, Wog, Wog, Wog, Wog, Wog, Wog, Wog, Wog, Wog, Wog, Wog, Wog, Wog, Wog, Wog, Wog, Wog, Wog, Wog, Wog, Wog, Wog, Wog, Wog, Wog, Wog, Wog, Wog, Wog, Wog, Wog, Wog, Wog, Wog, Wog, Wog, Wog, Wog, Wog, Wog, Wog, Wog, Wog, Wog, Wog, Wog, Wog, Wog, Wog, Wog, Wog, Wog, Wog, Wog, Wog, Wog, Wog, Wog, Wog, Wog, Wog, Wog, Wog
Wog, Wog, Wog, Wog, Wog, Wog, Wog, Wog, Wog, Wog, Wog, Wog, Wog, Wog, Wog, Wog, Wog, Wog, Wog, Wog, Wog, Wog, Wog, Wog, Wog, Wog, Wog, Wog, Wog, Wog, Wog, Wog, Wog, Wog, Wog, Wog, Wog, Wog, Wog, Wog, Wog, Wog, Wog, Wog, Wog, Wog, Wog, Wog, Wog, Wog, Wog, Wog, Wog, Wog, Wog, Wog, Wog, Wog, Wog, Wog, Wog, Wog, Wog, Wog, Wog, Wog, Wog
