Xu, Xu, Xu, Xu, Xu, Xu, Xu, Xu, Xu, Xu, Xu, Xu, Xu, Xu, Xu, Xu, Xu, Xu, Xu, Xu, Xu, Xu, Xu, Xu, Xu, Xu, Xu, Xu, Xu, Xu, Xu, Xu, Xu, Xu, Xu, Xu, Xu, Xu, Xu
Xu, Xu, Xu, Xu, Xu, Xu, Xu, Xu, Xu, Xu, Xu, Xu, Xu, Xu, Ur, Xu, Ur, Ur, Ur, Ur, Ur, Ur, Ur, Xu, Xu, Xu, Xu, Xu, Xu, Xu, Xu, Xu, Xu, Xu, Xu, Xu, Xu, Xu, Xu
Xu, Xu, Xu, Xu, Xu, Xu, Xu, Xu, Xu, Xu, Xu, Xu, Ur, Ur, Ur, Ur, Ur, Ur, Ur, Ur, Ur, Ur, Ur, Ur, Ur, Xu, Xu, Xu, Xu, Xu, Xu, Xu, Xu, Xu, Xu, Xu, Xu, Xu, Xu
Xu, Xu, Xu, Xu, Xu, Xu, Xu, Xu, Xu, Xu, Xu, Xu, Ur, Ur, Ur, Ur, Ur, Ur, Cud, 4 Kud, Cud, Ur, Ur, Ur, Ur, Xu, Xu, Xu, Xu, Xu, Xu, Xu, Xu, Xu, Xu, Xu, Xu, Xu, Xu
Xu, Xu, Xu, Xu, Xu, Xu, Xu, Xu, Xu, Xu, Xu, Ur, Ur, Ur, Ur, Ur, Ur, Cud, Cud, Cud, Cud, Cud, Ur, Ur, Ur, Ur, Ur, Xu, Xu, Xu, Xu, Xu, Xu, Xu, Xu, Xu, Xu, Xu, Xu
Xu, Xu, Xu, Xu, Xu, Xu, Xu, Xu, Xu, Xu, Xu, Xu, Ur, Ur, Ur, Ur, Ur, Ur, Ur, Ur, Ur, Ur, Ur, Ur, Ur, Ur, Ur, Xu, Xu, Xu, Xu, Xu, Xu, Xu, Xu, Xu, Xu, Xu, Xu
Xu, Xu, Xu, Xu, Xu, Xu, Xu, Xu, Xu, Xu, Xu, Ur, Ur, Ur, Ur, Ur, Ur, Ur, Ur, Ur, Ur, Ur, Ur, Ur, Ur, Ur, Xu, Xu, Xu, Xu, Xu, Xu, Xu, Xu, Xu, Xu, Xu, Xu, Xu
Xu, Xu, Xu, Xu, Xu, Xu, Xu, Xu, Xu, Xu, Xu, Xu, Xu, Ur, Ur, Ur, Ur, Ur, Ql, Ql^Bs|, Ql, Ur, Ur, Ur, Ur, Ur, Xu, Xu, Rb, Xu, Xu, Xu, Xu, Xu, Xu, Xu, Xu, Xu, Xu
Xu, Xu, Xu, Xu, Xu, Xu, Rb, Rb, Rb, Rb, Rb, Hhd, Rb, Xu, Xu, Xu, Xu, Ur, Xu, Ql^Bs|, Xu, Ur, Xu, Xu, Xu, Xu, Rb, Hhd, Rb, Hhd, Hhd, Hhd, Hhd, Xu, Xu, Xu, Xu, Xu, Xu
Xu, Xu, Xu, Xu, Hhd, Rb, Hhd, Rb, Rb, Rb, Hhd, Hhd, Rb, Rb, Hhd, Hhd, Ql, Xu, Ql, Ql^Bs|, Ql, Xu, Ql, Hhd, Rb, Rb, Rb, Rb, Hhd, Hhd, Rb, Hhd, Rb, Rb, Rb, Hhd, Rb, Xu, Xu
Rb, Xu, Hhd, Hhd, Rb, Hhd, Hhd, Rb, Rb, Rb, Hhd, Rb, Hhd, Rb, Hhd, Hhd, Rb, Ql, Rb, Ql^Bs|, Rb, Ql, Rb, Rb, Rb, Rb, Hhd, Rb, Rb, Rb, Rb, Rb, Hhd, Rb, Rb, Rb, Rb, Rb, Hhd
Rb, Rb, Rb, Hhd, Hhd, Hhd, Rb, Hhd, Hhd, Rb, Rb, Rb, Rb, Rb, Rb, Rb, Hhd, Rb, Rb, Rb, Hhd, Rb, Rb, Rb, Rb, Rb, Hhd, Hhd, Hhd, Rb, Rb, Rb, Hhd, Hhd, Hhd, Hhd, Rb, Hhd, Rb
Rb, Rb, Rb, Hhd, Hhd, Rb, Rb, Rb, Rb, Rb, Hhd, Rb, Hhd, Hhd, Rb, Rb, Rb, Rb, Rb, Hhd, Hhd, Hhd, Hhd, Rb, Rb, Hhd, Rb, Rb, Rb, Hhd, Hhd, Rb, Rb, Rb, Rb, Rb, Rb, Hhd, Hhd
Hhd, Hhd, Hhd, Rb, Hhd, Hhd, Hhd, Rb, Rb, Rb, Rb, Rb, Rb, Rb, Rb, Hhd, Hhd, Rb, Rb, Hhd, Hhd, Hhd, Rb, Rb, Rb, Hhd, Rb, Rb, Rb, Hhd, Rb, Rb, Rb, Rb, Rb, Rb, Rb, Hhd, Hhd
Mdd, Rb, Rb, Hhd, Hhd, Rb, Hhd, Rb, Rb, Rb, Rb, Rb, Rb, Rb, Hhd, Hhd, Hhd, Hhd, Rb, Rb, Rb, Rb, Rb, Rb, Rb, Rb, Hhd, Rb, Hhd, Rb, Rb, Rb, Hhd, Hhd, Hhd, Hhd, Hhd, Rb, Rb
Mdd, Mdd, Mdd, Hhd, Mdd, Mdd, Mdd, Mdd, Mdd, Mdd, Mdd, Rb, Rb, Rb, Rb, Rb, Rb, Rb, Rb, Rb, Rb, Hhd, Rb, Rb, Hhd, Hhd, Hhd, Hhd, Rb, Rb, Rb, Hhd, Hhd, Rb, Hhd, Hhd, Rb, Hhd, Hhd
Mdd^Xm, Mdd, Mdd^Xm, Mdd, Mdd^Xm, Mdd, Mdd, Mdd, Mdd, Mdd, Mdd, Mdd, Rb, Rb, Rb, Hhd, Hhd, Hhd, Rb, Rb, Hhd, Rb, Hhd, Rb, Hhd, Hhd, Rb, Rb, Rb, Rb, Rb, Rb, Mdd, Hhd, Mdd, Mdd, Mdd, Mdd, Mdd
Mdd, Mdd^Xm, Mdd^Xm, Mdd^Xm, Mdd^Xm, Mdd^Xm, Mdd^Xm, Mdd^Xm, Mdd^Xm, Mdd^Xm, Mdd^Xm, Mdd^Xm, Rb, Rb, Mdd, Rb, Rb, Hhd, Rb, Rb, Hhd, Rb, Hhd, Rb, Rb, Hhd, Hhd, Rb, Rb, Rb, Mdd, Mdd, Mdd, Mdd, Mdd, Mdd, Mdd^Xm, Mdd^Xm, Mdd^Xm
Mdd, Mdd, Mdd, Mdd, Mdd, Mdd, Mdd, Mdd^Xm, Mdd, Mdd, Rb, Rb, Mdd^Xm, Mdd, Mdd^Xm, Mdd, Mdd, Mdd, Mdd, Hhd, Mdd, Mdd, Mdd, Mdd, Mdd, Mdd, Mdd, Rb, Rb, Rb, Mdd, Mdd, Mdd^Xm, Mdd, Mdd^Xm, Mdd^Xm, Mdd^Xm, Mdd^Xm, Mdd
Gg, Gd, Hhd, Mdd, Mdd, Mdd, Mdd, Mdd, Hhd, Mdd, Rb, Rb, Mdd, Mdd^Xm, Mdd^Xm, Mdd^Xm, Mdd^Xm, Mdd^Xm, Mdd^Xm, Mdd, Mdd^Xm, Mdd, Mdd^Xm, Mdd, Mdd^Xm, Mdd, Mdd, Mdd, Mdd^Xm, Rb, Mdd^Xm, Mdd^Xm, Mdd^Xm, Mdd^Xm, Mdd, Mdd, Mdd, Mdd, Mdd
Hhd, Gd, Gd, Gd, Gd, Hhd, Hhd, Gd, Gg, Rb, Rb, Mdd, Mdd, Mdd, Mdd, Mdd^Xm, Mdd^Xm, Mdd^Xm, Mdd^Xm, Mdd^Xm, Mdd^Xm, Mdd^Xm, Mdd^Xm, Mdd^Xm, Mdd^Xm, Mdd^Xm, Mdd^Xm, Mdd^Xm, Mdd, Rb, Rb, Mdd, Mdd, Mdd, Mdd, Mdd, Hh, Mdd, Gd
Hhd, Hh, Hhd, Gs, Hh, Gd, Gd, Gd, Hhd, Hhd, Gd, Rb, Hh, Mdd, Mdd, Mdd, Mdd, Mdd, Mdd, Mdd^Xm, Mdd, Mdd^Xm, Mdd, Mdd^Xm, Mdd, Mdd^Xm, Mdd, Mdd, Mdd, Rb, Rb, Rb, Hhd, Gd, Hhd, Hhd, Gs, Gs, Hhd
Gd, Hhd, Gg, Hhd, Gg, Gd, Gd, Gd, Hhd, Gd, Gg, Gd, Hhd, Hhd, Hhd, Gd, Hhd, Mdd, Mdd, Mdd, Mdd, Mdd, Hhd, Mdd, Hhd, Mdd, Hh, Mdd, Gg, Rb, Gs, Gd, Gd, Hh, Gd, Gd, Hhd, Gs, Hhd
Gs, Hhd, Hhd, Gd, Hhd, Gd, Gd, Gd, Gs, Gd, Hhd, Gg, Hh, Hhd, Hhd, Gg, Gd, Hh, Gs, Gg, Gd, Hh, Gd, Hhd, Hh, Gd, Hhd, Hhd, Hhd, Hhd, Gs, Gd, Hhd, Hhd, Hhd, Gs, Gs, Gs, Hhd
Gd, Gd, Gd, Gs, Gg, Hhd, Gd, Hhd, Hhd, Gg, Gg, Hhd, Hhd, Gd, Hhd, Gd, Hhd, Gs, Hhd, Hhd, Gd, Hhd, Hh, Hhd, Gs, Hhd, Hhd, Gs, Gd, Gd, Hhd, Gd, Gd, Hhd, Hh, Gs, Gd, Hh, Hh
Gd, Gd, Gg, Gd, Gg, Gs, Gd, Hhd, Gd, Hh, Gd, Gd, Gd, Gd, Gs, Gd, Gd, Hhd, Gs, Gd, Gs, Hhd, Hh, Gd, Hh, Hhd, Hhd, Gd, Hhd, Gg, Hh, Gs, Gd, Hhd, Gd, Hh, Hhd, Gs, Hhd
Gg, Gd, Gg, Gd, Gd, Gg, Gd, Gd, Gg, Gd, Gd, Gs, Gs, Gg, Hhd, Hh, Hhd, Hhd, Hhd, Hhd, Hh, Hhd, Hhd, Gd, Gs, Hh, Gd, Hhd, Hhd, Hhd, Gd, Hhd, Hhd, Gg, Gd, Gd, Hhd, Gd, Gd
Gd, Gg, Gg, Gg, Gg, Gd, Gd, Gd, Gd, Gg, Gg, Gd, Gg, Gs, Gd, Gd, Gd, Hh, Gd, Hhd, Gd, Gs, Hhd, Gd, Gg, Hh, Gd, Hhd, Hhd, Hhd, Hhd, Hh, Gd, Gs, Gd, Hhd, Gd, Gg, Gd
Wwf, Gg, Gg, Gd, Gg, Gg, Gg, Gg, Gg, Gg, Gg, Gd, Gd, Gg, Gd, Gd, Gg, Gd, Gg, Gd, Gd, Gd, Gd, Gd, Gd, Hhd, Gd, Gd, Gd, Hh, Gd, Gd, Gg, Gd, Gg, Gd, Gg, Gd, Gd
Wwf, Wwf, Wwf, Gg, Gd, Gg, Gd, Gg, Gg, Gg, Gg, Gd, Gd, Gg, Gd, Gg, Gg, Gd, Gd, Gg, Gd, Gg, Gg, Gd, Gg, Gg, Gd, Gg, Gg, Gd, Gd, Gd, Gd, Gd, Gg, Gg, Gd, Gd, Gd
Wwf, Wwf, Wwf, Wwf, Gg, Gd, Gg, Gg, Gd, Gg, Gd, Gd, Gg, Gg, Gd, Gg, Gd, Gg, Gd, Gg, Gd, Gg, Gd, Gd, Gd, Gg, Gd, Gd, Gd, Gg, Gd, Gg, Gg, Gd, Gd, Gg, Gd, Gg, Gg
Ww, Ww, Ww, Wwf, Wwf, Gg, Gg, Gg, Gg, Gg, Wwf, Gd, Gg, Gg, Gg, Gg, Gd, Gg, Gg, Gd, Gd, Gg, Gg, Gg, Gg, Gd, Gg, Gd, Gd, Gd, Gg, Gg, Gd, Gg, Gd, Gg, Gg, Gd, Gd
Ww, Ww, Ww, Ww, Ww, Gg, Gg, Gd, Wwf, Gg, Wwf, Wwf, Wwf, Gg, Wwf, Gg, Gg, Gg, Gg, Gg, Gg, Gg, Gg, Gd, Gg, Gg, Gg, Gg, Gd, Gg, Gd, Gg, Gd, Gd, Gg, Gg, Gg, Gg, Wwf
Wo, Wo, Wo, Ww, Wo, Ww, Wo^Bsb|, Ww, Ww, Ww, Ww, Wwf, Ww, Wwf, Ww, Wwf, Wwf, Gg, Gg, Gg, Gg, Gg, Gg, Gg, Gd, Gg, Gg, Gd, Gd, Gd, Gg, Gg, Gg, Gd, Gd, Gd, Wwf, Wwf, Wwf
Ww, Wo, Ww, Wo, Wo, Wo, Wo^Bsb|, Wo, Wo, Ww, Wo, Ww, Ww, Ww, Ww, Ww, Ww, Wwf, Wwf, Gg, Gg, Gg, Gg, Gg, Gg, Gg, Wwf, Gg, Gg, Gg, Gg, Gg, Gg, Gg, Gg, Wwf, Ww, Ww, Ww
Wwf, Ww, Wwf, Ww, Ww, Wo, Ww^Bsb|, Ww, Ww, Wo, Wo, Wo, Wo, Wo, Wo, Wo, Wo, Ww, Ww, Ww, Ww^Bsb|, Gg, Ww, Wwf, Wwf, Wwf, Wwf, Wwf, Wwf, Wwf, Wwf, Gg, Gg, Gg, Wwf, Wwf, Ww, Wo, Wo
Gg, Wwf, Gg, Wwf, Wwf, Ww, Gg, Wwf, Wwf, Ww, Ww, Wo, Ww, Ww, Ww, Ww, Ww, Wo, Wo, Wo, Wo^Bsb|, Wo, Wo, Ww, Wo, Wwf, Wo, Ww, Wo, Ww, Wo, Gg, Ww^Bsb|, Wwf, Wo, Wo, Wo, Wo, Wo
Gg, Gg, Gg, Gg, Gg, Gg, Gg, Gg, Wwf, Wwf, Wwf, Ww, Ww, Ww, Ww, Ww, Ww, Ww, Ww, Wo, Ww^Bsb|, Wo, Ww, Wo, Wo, Wo, Wo, Wo, Wo, Wo, Wo, Wo, Wo^Bsb|, Wo, Wo, Wo, Ww, Wo, Ww
Gg, Gg, Gg, Gg, Gg, Gg, Gg, Gg, Gg, Gg, Gg, Wwf, Gg, Wwf, Wwf, Ww, Wwf, Ww, Ww, Ww, Gg, Ww, Ww, Ww, Ww, Ww, Ww, Ww, Ww, Ww, Ww, Ww, Ww^Bsb|, Wwf, Wwf, Wo, Ww, Ww, Ww
Gg, Gg, Gg, Gg, Gg, Gg, Gg, Gg, Gg, Gg, Gg, Gg, Gg, Gg, Gg, Wwf, Gg, Wwf, Gg, Wwf, Gg, Gg, Gg, Wwf, Wwf, Ww, Ww, Ww, Wwf, Ww, Wwf, Gg, Gg, Wwf, Gg, Wwf, Wwf, Wwf, Wwf
Gg, Gg, Gg, Gg, Gg, Gg, Gg, Gg, Gg, Gll^Fmw, Gg, Gll^Fmw, Gg, Gg, Gg, Gg, Gg, Gg, Gg, Gg, Gg, Gg, Gg, Gg, Gg, Gg, Gg, Wwf, Gg, Wwf, Gg, Gg, Gg, Gg, Gg, Gg, Gg, Wwf, Wwf
Gg, Gg, Gll^Fmw, Gg, Gg, Gg, Gll^Fmw, Gg, Gg, Gg, Gg, Gll^Fmw, Gg, Gg, Gg, Gg, Gg, Gg, Gg, Gg, Gg, Gll^Fmw, Gg, Gg, Gg, Gll^Fmw, Gg, Gg, Gg, Gg, Gg, Gg, Gg, Gg, Gg, Gg, Gg, Gg, Gg
Gg, Gg, Gg, Gg, Gg, Gg, Gg, Gg, Gll^Fmw, Gg, Gg, Gll^Fmw, Gg, Gg, Gg, Gll^Fmw, Gg, Gg, Gg, Gg, Gg, Gg, Gg, Gg, Gg, Gg, Gll^Fmw, Gg, Gg, Gg, Gg, Gg, Gg, Gg, Gg, Gg, Gg, Gll^Fmw, Gg
Gg, Gg, Gg, Gg, Gg, Gg, Gg, Gll^Fmw, Gg, Gll^Fmw, Gg, Gg, Gg, Gg, Gg, Gg, Gll^Fmw, Gll^Fmw, Gg, Gg, Gg, Gg, Gg, Gll^Fmw, Gg, Gg, Gll^Fmw, Gg, Gg, Gg, Gg, Gg, Gg, Gg, Gg, Gg, Gg, Gll^Fmw, Gg
Gg, Gg, Gg, Gg, Gg, Gg, Gg, Gg, Gll^Fmw, Gg, Gg, Gg, Gg, Gg, Gg, Gg, Gg, Gg, Gg, Gg, Gg, Gg, Gg, Gg, Gll^Fmw, Gg, Gg, Gg, Gg, Gg, Gg, Gg, Gg, Gg, Gg, Gg, Gg, Gg, Gll^Fmw
Gg, Gg, Gg, Gg, Gg, Gll^Fmw, Gg, Gg, Gg, Gll^Fmw, Gg, Gg, Gg, Gg, Gg, Gg, Gll^Fmw, Gg, Gg, Gg, Gg, Gll^Fmw, Gll^Fmw, Gll^Fmw, Gg, Gll^Fmw, Gg, Gg, Gg, Gll^Fmw, Gg, Gg, Gg, Gll^Fmw, Gg, Gg, Gg, Gg, Gg
Gg, Gg, Gll^Fmw, Gg, Gg, Gg, Gg, Gg, Gg, Gg, Gg, Gg, Gll^Fmw, Gg, Gg, Gll^Fmw, Gg, Gg, Gg, Gg, Gg, Gg, Gg, Gg, Gg, Gg, Gll^Fmw, Gg, Gg, Gll^Fmw, Gg, Gg, Gll^Fmw, Gg, Gg, Gg, Gg, Gg, Gg
Gg, Gg, Gg, Gll^Fmw, Gg, Gg, Gg, Gll^Fmw, Gg, Gll^Fmw, Gll^Fmw, Gg, Gg, Gg, Gg, Gll^Fmw, Gg, Gll^Fmw, Gll^Fmw, Gg, Gll^Fmw, Gg, Gg, Gll^Fmw, Gg, Gg, Gg, Gg, Gg, Gg, Gg, Gg, Gg, Gll^Fmw, Gg, Gg, Gg, Gg, Gg
Gg, Gg, Gg, Gg, Gg, Gll^Fmw, Gg, Gg, Gg, Gg, Gll^Fmw, Gg, Gll^Fmw, Gg, Gg, Gg, Gg, Gg, Gg, Gg, Gg, Gg, Gg, Gg, Gg, Gg, Gg, Gll^Fmw, Gg, Gll^Fmw, Gg, Gll^Fmw, Gg, Gll^Fmw, Gll^Fmw, Gg, Gg, Gll^Fmw, Gg
Gg, Gll^Fmw, Gg, Gg, Gg, Gg, Gg, Gg, Gg, Gg, Gg, Gg, Gg, Gll^Fmw, Gg, Gg, Gg, Gg, Gg, Gll^Fmw, Gll^Fmw, Gg, Gll^Fmw, Gg, Gg, Gg, Gg, Gg, Gg, Gg, Gg, Gg, Gll^Fmw, Gg, Gg, Gll^Fmw, Gg, Gg, Gg
Gg, Gg, Gg, Gg, Gg, Gll^Fmw, Gll^Fmw, Gll^Fmw, Gg, Gg, Gll^Fmw, Gg, Gg, Gg, Gg, Gg, Gg, Gg, Gll^Fmw, Gll^Fmw, Gg, Gg, Gll^Fmw, Gg, Gll^Fmw, Gg, Gg, Gg, Gg, Gll^Fmw, Gg, Gg, Gg, Gg, Gg, Gll^Fmw, Gg, Gg, Gg
Gg, Gg, Gg, Gg, Gg, Gg, Gg, Gg, Gg, Gg, Gll^Fmw, Gg, Gg, Gg, Gg, Gg, Gll^Fmw, Gg, Gg, Gg, Gll^Fmw, Gg, Gg, Gg, Gg, Gg, Gll^Fmw, Gll^Fmw, Gg, Gg, Gg, Gg, Gg, Gg, Gg, Gg, Gg, Gg, Gll^Fmw
Gg, Gg, Gg, Gg, Gg, Gg, Gll^Fmw, Gg, Gg, Gg, Gg, Gg, Gg, Gll^Fmw, Gg, Gg, Gg, Gll^Fmw, Gg, Gll^Fmw, Gg, Gg, Gg, Gg, Gg, Gg, Gg, Gg, Gg, Gg, Gg, Gg, Gg, Gg, Gg, Gg, Gg, Gg, Gg
Gg, Gg, Gg, Gg, Gll^Fmw, Gg, Gg, Gg, Gg, Gg, Gg, Gg, Gg, Gg, Gg, Gg, Gg, Gg, Gg, Gg, Gg, Gg, Gll^Fmw, Gg, Gll^Fmw, Gg, Gg, Gg, Gll^Fmw, Gll^Fmw, Gg, Gll^Fmw, Gg, Gg, Gg, Gg, Gg, Gg, Gg
Gg, Gll^Fmw, Gg, Gll^Fmw, Gg, Gg, Gg, Gg, Gg, Gll^Fmw, Gg, Gg, Gll^Fmw, Gg, Gg, Gg, Gg, Gg, Gg, Gg, Gg, Gg, Gg, Gg, Gg, Gg, Gg, Gg, Gg, Gg, Gg, Gg, Gg, Gg, Gg, Gg, Gg, Gll^Fmw, Gg
Gg, Gll^Fmw, Gg, Gll^Fmw, Gg, Gg, Ch, Gg, Ch, Gg, Gg, Gg, Gg, Gg, Gg, Gg, Gg, Gg, Ch, Gg, Ch, Gg, Gg, Gg, Gg, Gg, Gg, Gg, Gg, Gg, Ch, Gg, Ch, Gg, Gg, Gg, Gll^Fmw, Gll^Fmw, Gg
Gg, Gg, Gg, Gg, Gg, Gg, Ch, Ch, Ch, Gg, Gg, Gg, Gg, Gg, Gg, Gll^Fmw, Gll^Fmw, Gll^Fmw, Ch, Ch, Ch, Gg, Gg, Gg, Gg, Gg, Gg, Gg, Gg, Gg, Ch, Ch, Ch, Gg, Gg, Gg, Gll^Fmw, Gg, Gg
Gg, Gg, Gg, Gg, Gg, Gg, Ch, 1 Kh, Ch, Gll^Fmw, Gg, Gll^Fmw, Gg, Gg, Gg, Gll^Fmw, Gg, Gll^Fmw, Ch, 2 Kh, Ch, Gg, Gll^Fmw, Gll^Fmw, Gll^Fmw, Gg, Gg, Gg, Gg, Gg, Ch, 3 Kh, Ch, Gg, Gg, Gg, Gg, Gll^Fmw, Gg
Gll^Fmw, Gg, Gg, Gg, Gg, Gg, Gg, Gg, Gg, Gll^Fmw, Gll^Fmw, Gg, Gg, Gg, Gll^Fmw, Gg, Gll^Fmw, Gll^Fmw, Gg, Gg, Gg, Gg, Gg, Gg, Gg, Gg, Gg, Gg, Gg, Gg, Gg, Gll^Fmw, Gg, Gll^Fmw, Gg, Gg, Gll^Fmw, Gll^Fmw, Gg
Gg, Gg, Gg, Gg, Gll^Fmw, Gll^Fmw, Gg, Gg, Gg, Gg, Gg, Gg, Gg, Gg, Gg, Gg, Gg, Gll^Fmw, Gg, Gg, Gll^Fmw, Gg, Gll^Fmw, Gll^Fmw, Gg, Gg, Gg, Gg, Gg, Gg, Gg, Gg, Gll^Fmw, Gg, Gg, Gll^Fmw, Gg, Gg, Gg
